************************
*         *           E*
*    *    *  ***********
*  * *    *    *
*    **  ***   *
*    *    *    *
*   S*       * *
****************
