#**********
#* E *    *
#*   ******
#*        *
#*   ******
#*        *
#* S      *
#**********
****
*  *
****
