#**********
#* E *    *
#*   ******
#*        *
#*   ******
#*        *
#* S      *
#**********
*****
*  **
*****
*****
