#**********
#* E *    *
#*   ******
#*        *
#*   ******
#*        *
#* S      *
#**********
*****
**E**
*   *
** S*
*****
